{
  "width":10,
  "height":10,
  "start":[0,0],
  "end":[9,9],
  "board":[
    [ 2, 0, 0, 6, 3, 0, 6, 7, 1, 2],
    [12, 7, 5,11,10, 2,10,10, 6, 9],
    [ 4,11, 4,11,10,10,10,14, 9, 0],
    [ 4, 9, 4, 9,10,10,10,12, 5, 3],
    [ 6, 5, 5, 3,10,10,10, 6, 5, 9],
    [12, 5, 3,12, 9,10,10,12, 5, 3],
    [ 6, 5, 9, 6, 5, 9,10, 6, 5, 9],
    [14, 5, 5, 9, 6, 5, 9,12, 5, 3],
    [12, 5, 5, 5,11, 6, 5, 5, 5, 9],
    [ 4, 5, 5, 5, 9,12, 5, 5, 5, 1]
  ]
}