{
  "width":10,
  "height":10,
  "start":[3,2],
  "end":[7,9],
  "board":[
  	[ 2, 4, 7, 5, 5, 3, 2, 6, 5, 3],
  	[12, 3,14, 1, 6,11,14,13, 3,10],
  	[ 4,11,10, 2,10,12, 9, 6, 9, 8],
  	[ 2,12,15,15,11, 4, 5,13, 7, 1],
  	[14, 5, 9,10, 8, 6, 1, 4,15, 3],
  	[ 8, 2, 6,11, 6,13, 7, 5,11,10],
  	[ 4,15, 9, 8,10, 2,10, 4,11, 8],
  	[ 2,10, 4, 5,11,10, 8, 6, 9, 2],
  	[14,13, 7, 3,14,13, 1,14, 3,10],
  	[ 8, 4, 9,12, 9, 4, 5, 9,12, 9]
  ]
}
