{
  "width":10,
  "height":10,
  "start":[0,0],
  "end":[9,9],
  "board":[
  	[ 2, 2, 6, 5, 5, 3, 6, 5, 7, 3],
  	[14,15, 9, 4, 5,15, 9, 2,10,10],
  	[10,12, 5, 5, 5, 9, 4,13, 9,10],
  	[14, 5, 5, 7, 5, 7, 5, 5, 5,11],
  	[12, 7, 5,15, 3, 8, 2, 6, 3,10],
  	[ 4,13, 5, 9,12, 5,11, 8,10, 8],
  	[ 4, 5, 7, 3, 2, 4,15, 7,15, 3],
  	[ 6, 5, 9,10,12, 5,11,10,10,10],
  	[12, 5, 1,10, 6, 1, 8,10,10,10],
  	[ 4, 5, 5,13,13, 5, 5, 9, 8, 8]
  ]
}